0000000011010000000000000000110100000000
0011100010000010000000111000100000100000
0010011000110010011000100110001100100110
0000001110110000011000000011101100000110
0011001110000111000000110011100001110000
0011000000011101111000110000000111011110
0000001000011101111000000010000111011110
0000101111011101111000001011110111011110
0000100100000000000000001001000000000000
0000110100111100000000001101001111000000
0000010110111100000000000101101111000000
0111000010111100000001110000101111000000
0111001110111100000001110011101111000000
0111001110000101000001110011100001010000
1100011111100100001011000111111001000010
0000001110000111000000000011100001110000
0000001110000111100000000011100001111000
0110001110110000111001100011101100001110
0110100000010000000001101000000100000000
0000000000000000000000000000000000000000
0000000011010000000000000000110100000000
0011100010000010000000111000100000100000
0010011000110010011000100110001100100110
0000001110110000011000000011101100000110
0011001110000111000000110011100001110000
0011000000011101111000110000000111011110
0000001000011101111000000010000111011110
0000101111011101111000001011110111011110
0000100100000000000000001001000000000000
0000110100111100000000001101001111000000
0000010110111100000000000101101111000000
0111000010111100000001110000101111000000
0111001110111100000001110011101111000000
0111001110000101000001110011100001010000
1100011111100100001011000111111001000010
0000001110000111000000000011100001110000
0000001110000111100000000011100001111000
0110001110110000111001100011101100001110
0110100000010000000001101000000100000000
0000000000000000000000000000000000000000