00000000000000000000000000000000000
00000000000000000000000000000000000
11111010111101011101001110101110101
11111010111101011101001110101110101
11111010111101011101001110101110101
11111010111101011101001110101110101
00000000000000000000000000000000000
00000000000000000000000000000000000
00000000000000000000000000000000000
10111110001100001111000110001111001
11111111001100011111100110001111001
10111110001100001111000110011111101
00000000000000000000000000000000001
00000000000000000000000000000000001
10000000000000000000000000000000001
11000011111000001111111100111111111
11100011111100000111111100111111111
11110001111110000011111110011111111
11111000111111000001111110001111111
11111100011111100000111111000111111
11111110001111110000011111000011111
11111111001111111000001111000001111
11111111100111111100000111110000111
10000000000000000000000000000000001
10000000000000000000000000000000001
10000000000000000000000000000000001
11111111100111111110011111111001111
00000000000000000000000000000000001
00000000000000000000000000000000000
00000000000000000000000000000000000
00000000000000000000000000000000000
00000000000000000000000000000000000
00000000000000000000000000000000000
00000000000000000000000000000000000
11111111111111111111111111111111111